1,1,1,1,1,1,1,
1,2,3,3|9,3,2,1,
1,2,3,3,3,2,1,
1,1,1,7|3,1,1,1,
1,1,1,3,1,1,1,1
1,3,3,6|3,3,3,3,1
1,1,1,1,1,1,3,1
,,,1,3,1,3,1
,,,1,3|8,3,3,1
,,,1,1,1,1,1
0,0,0,0,0,0,0,0
0,0,0,0,0,0,0,0
